EUR = "countries/Europe.txt"
ITY = "countries/CCO Italy.txt"
GBR = "countries/CCO Great Britan.txt"
SCA = "countries/CCO Scandinavia.txt"
IBR = "countries/CCO Iberia.txt"
FRK = "countries/CCO Frankish.txt"
GRM = "countries/CCO Germania.txt"
SVA = "countries/CCO Slavia.txt"
RTN = "countries/CCO Ruthenia.txt"
BLK = "countries/CCO Balkans.txt"
RUS = "countries/CCO Russia.txt"

NAM = "countries/North America.txt"
2AC = "countries/America Caribbean.txt"
2CA = "countries/Central America.txt"

SSA = "countries/South America.txt"
NSA = "countries/North South America.txt"

ASA = "countries/Asia.txt"
IND = "countries/India.txt"
SEA = "countries/South East Asia.txt"
2JP = "countries/Japan.txt"
MDE = "countries/Middle East.txt"
2MN = "countries/Mongolia.txt"
2MC = "countries/Manchuria.txt"
2CN = "countries/China.txt"
2CS = "countries/China.txt"
2CI = "countries/China.txt"

AFR = "countries/Africa.txt"
AFN = "countries/North Africa.txt"
AFE = "countries/East Africa.txt"
AFS = "countries/South Africa.txt"

OCE = "countries/Oceania.txt"
2PY = "countries/Polynesia.txt"